+----+---+---------------------------------------------------+-------------------------------+------+
|    |                                                                                       |      |
|    |   |         |                                         +-------------------------------+      |
|    |   +---------+                                                                                |
|    |   |                  +---------------------+                +----------------------+         |
|    |   |    +----+        |                     |     +----+     |                      |         |
|    |   |    |    |        |    +----|           |     |    |     |             +--------+         |
|    |   |    |    |        |         |           |     |    |     |                                |
|    |   |    +---------+   |         |           |     |    |     |                                |
|    |   |         |    |   |         |           |     |    |     |                      |         |
|    |   |         |    |   |         |           |     |    |     |                      |         |
|    |   |         |    |   |         |           |     |    |     +----------------------+---------+
|    +---+         +----+   |         +-----------+     |    |                                      |
|                           |                           |    |                                      |
+--------+  +-----------+   |                           |    |       +----------+                   |
|        |              |   |                           |    |       |          |                   |
|        |  |           |   |                           |    |       |          |     +----+        |
|        |  +-----------+   |     +---------------+     |    |       |   +      |     |    |        |
|        |                  |     |               |     |    |       |   |      |     |    |        |
|        |  +-----------+   |                     |     |    |       |   |      |     |    |        |
+-  -----+              |   |                     |     |    |       |   |      |     |    |        |
|                       |   +---------------------+     |    |       |   |      |     |    |        |
|   +----+  |           |                               |    |       +---+      |     |    +--------+
|   |    |  |           |   +-------+                   |    |                  |     |    |        |
|   |    |  +-----------+   |       |                   |    |                  |     |    |        |
|   +----+                  |       |                   |    |       +----------+     +----+        |
|           +---------------+-------+------------+      +----+                                      |
|           |                                    |                                             X    |
+-----------+------------------------------------+--------------------------------------------------+
