+------+------+---------------------+--------+-------------------------------+
|      |      |                     |        |                        +------+
|      |      |                     |        |                        |      |
|      |      |                     |        |                        |      |
|      |      |                     |        |                        |      |
|      |      |                     |        |                        |      |
|      |      |                     |        |                        |      |
|      |      |                     |        |                        |      |
|      |      |    +-------+        |        |                        |      |
|      |      |    |       |        |        |                        +------+
|      |      |    |       |        |        |            +------+           |
|      |      |    |       |        |        |            |      |           |
|      |      |    |       |        |        |            |      |           |
|      +------+    |       |        |        |            |      |           |
|                  |       |        |        |            |      |           |
|                  |       |        |        |            |      |           |
|                  |       |        +--------+            |      |           |
|                  |       |                              |      |           |
|                  |       |                              |      |        X  |
+------------------+-------+------------------------------+------+-----------+
