+-----+----+-----------------------------------------------+
|     |    |                                               |
|     |                                                    |
|     |    |                                               |
|     |    |        +--------------------------------+     |
|     |    |                                               |
|     |    |                                               |
|     |    |        +-------------------------------+      |
|     |    |        |                                      |
|     +----+        |                                      |
|                   +------------------------+      +------+
|                                            |      |      |
|                                            |             |
|              +-----------------------------+      +------+
|              |                                           |
|              |          +------------------+      +------+
|              |                             |             |
|              |          |                  |  X   |      |
|              |          |                  |      |      |
+--------------+----------+------------------+------+------+
